                        
####################     #
#              #   #     #
#              #   #  X  #
#              #   #     #
#              #   #     #
#              #   #     #
#              #   #     #
#              #   #     #
#              #   #     #
#    ###########   #     #
#              #   #     #
#              #   #     #
#              #   #     #
#              #   #     #
#                        #
#                        #
#                        #
#                        #
##########################
