                        
##########################
#                  #     #
#                  #  X  #
#                  #     #
#                  #     #
#                  #     #
#                  #     #
#                  #     #
#                  #     #
#                  #     #
#                  #     #
#                  #     #
#                  #     #
#                  #     #
#                        #
#                        #
#                        #
#                        #
##########################
