                        
####################################################
#              #         #
#              #         #
#              #    X    #
#              #         #
#              #         #
#              #         #
#              #         #
#        #######         #
#              #         #
#              #         #
#              #         #
#              #         #
#                        #
#                        #
#                        #
#                        #
##########################
