

#              #         #
#              #         #
#              #    X    #
#              #         #
#              #         #
#              #         #
#              #         #
#        #######         #
#              #         #
#              #         #
#              ###       #
#              #         #
######                   #
#                    #####
#                        #
#                        #
##########################
