                        
####################################################
#                        #
#                        #
#                   X    #
#                        #
#                        #
#                        #
#                        #
#      #######           #
#            #           #
#            #           #
#            #           #
#            #           #
#                        #
#                        #
#                        #
#                        #
##########################
