#                        #
 #                       # 
                         #
#                        #
#                        #
 #                       # 
                         #
#                        #
#                        #
 #                        
#                        
 #                         
#                       
 # X                 ###   
 #                     
#                        
# ## # # ## # # 
## # ## # #  ## 
